01111111111111111111
01110000000011111111
00000111111000011111
11110111111011011111
11100111111000000011
11110111111011011011
11110000000000011011
11110111111111111011
11110111111111111001
11111111111111111100
